######################################################
#						#						     #
#						#							 #
#						O							 #
#						#							 #
#						#							 #
#						#							 #
#						#							 #
#						#							 #
######################################################