******************************************************************
*	RACE														 *
*	CLASS														 *
*																 *
******************************************************************